111111111111111111111111
100010001000000010000001
111010111110111110101111
101000100000000010100001
101010101010101111011101
100010001010100010000101
111011111010111110110111
101010100010000010100101
101110101111111010001101
100010001000000001010001
101010101011111101010101
101010101000000101010101
111011101110111101110101
100000100010100000000101
101011101110111011111101
101000000010001010010001
101110111011101110111101
101010001010100010000001
101011111110111110111111
100010100010000010000001
101110101010111111110111
101000000000100001000101
100011111000000000000002
111111111111111111111122