111111111111111111111111
100000101010000000000001
101111101010111010101101
100000101010101010100011
111011101010101111110111
100010000000000000010001
101111111110101011101111
100010101000101010100001
111010101011101110101101
100010001010001000010001
111011101011111111111101
100000100000101000010001
101110101010101110111101
101010001010001000010101
111011101011111011010101
101000001000000010000101
101111101010101011111111
100000001010101010010001
101010111110111010111101
101010101000101000100001
101110101111101011111101
101010101010001000000001
101010101010111010111102
111111111111111111111122
